白海狮
⠀⠀⠀⠀⠀⠀⠀⠀⠀⠀⠀⠀⠀⠀⠀⠀⠀⠀⠀⠀⠀⠀⠀⠀⠀⠀⠀⠀⠀⠀⢀⣾⠿⣶⠀⠀⠀⠀⠀⠀⠀⠀⠀⠀⠀⠀⠀⠀⠀⠀⠀⠀⠀⠀⠀⠀⠀⠀⠀⠀⠀⠀⠀⠀⠀
⠀⠀⠀⠀⠀⠀⠀⠀⠀⠀⠀⠀⠀⠀⠀⠀⠀⠀⠀⠀⠀⠀⠀⠀⠀⠀⠀⠀⠀⠀⣼⠃⠀⠹⣧⠀⠀⠀⠀⠀⠀⠀⠀⠀⠀⠀⠀⠀⠀⠀⠀⠀⠀⠀⠀⠀⠀⠀⠀⠀⠀⠀⠀⠀⠀
⠀⠀⠀⠀⠀⠀⠀⠀⠀⠀⠀⠀⠀⠀⠀⠀⠀⠀⠀⠀⠀⠀⠀⠀⠀⠀⣀⣤⡴⠟⠁⠀⠀⠀⢿⡄⠀⠀⠀⠀⠀⠀⠀⠀⠀⠀⠀⠀⠀⠀⠀⠀⠀⠀⠀⠀⠀⠀⠀⠀⠀⠀⠀⠀⠀
⠀⠀⠀⠀⠀⠀⠀⠀⠀⠀⠀⠀⠀⠀⠀⠀⠀⠀⠀⠀⠀⠀⠀⠀⠀⣼⠏⠀⢀⠀⠀⠀⣠⠀⠈⣿⡀⠀⠀⠀⠀⠀⠀⠀⠀⠀⠀⠀⠀⠀⠀⠀⠀⠀⠀⠀⠀⠀⠀⠀⠀⠀⠀⠀⠀
⠀⠀⠀⠀⠀⠀⠀⠀⠀⠀⠀⠀⠀⠀⠀⠀⠀⠀⠀⠀⠀⠀⠀⠀⠀⣿⡀⠀⠈⢷⣄⠀⠸⣆⠀⠘⣷⡀⠀⠀⠀⠀⠀⠀⠀⠀⠀⠀⠀⠀⠀⠀⠀⠀⠀⠀⠀⠀⠀⠀⠀⠀⠀⠀⠀
⠀⠀⠀⠀⠀⠀⠀⠀⠀⠀⠀⠀⠀⠀⠀⠀⠀⠀⠀⠀⠀⠀⠀⠀⠀⣸⠇⠀⠀⠀⠹⣦⡀⠻⣦⠀⠈⢷⡄⠀⠀⠀⠀⠀⠀⠀⠀⠀⠀⠀⠀⠀⠀⠀⠀⠀⠀⠀⠀⠀⠀⠀⠀⠀⠀
⠀⠀⠀⠀⠀⠀⠀⠀⠀⠀⠀⠀⠀⠀⠀⠀⠀⠀⠀⠀⠀⠀⠀⠀⢰⡏⠀⠀⠀⠀⠀⠈⠙⢦⣝⣧⡀⠈⠻⣆⠀⠀⠀⠀⠀⠀⠀⠀⠀⠀⠀⠀⠀⠀⠀⠀⠀⠀⠀⠀⠀⠀⠀⠀⠀
⠀⠀⠀⠀⠀⠀⠀⠀⠀⠀⠀⠀⠀⠀⠀⠀⠀⠀⠀⠀⠀⠀⠀⠀⣿⠀⠀⠀⠀⠀⠀⠀⠀⠀⠀⠈⠻⣦⡀⠙⢷⣄⠀⠀⠀⠀⠀⠀⠀⠀⠀⠀⠀⠀⠀⠀⠀⠀⠀⠀⠀⠀⠀⠀⠀
⠀⠀⠀⠀⠀⠀⠀⠀⠀⠀⠀⠀⠀⠀⠀⠀⠀⠀⠀⠀⠀⠀⠀⠀⠹⣧⠀⠀⠀⠀⠀⠀⠀⠀⠀⠀⠀⠈⠻⣦⡀⠙⢷⣄⠀⠀⠀⠀⠀⠀⠀⠀⠀⠀⠀⠀⠀⠀⠀⠀⠀⠀⠀⠀⠀
⠀⠀⠀⠀⠀⠀⠀⠀⠀⠀⠀⠀⠀⠀⠀⠀⠀⠀⠀⠀⠀⠀⠀⠀⠀⢸⡇⠀⠀⠀⠀⠀⠀⠀⠀⠀⠀⠀⠀⠈⠻⢦⣄⠉⠻⣦⣀⠀⠀⠀⠀⠀⠀⠀⠀⠀⠀⠀⠀⠀⠀⠀⠀⠀⠀
⠀⠀⠀⠀⠀⠀⠀⠀⠀⠀⠀⠀⠀⠀⠀⠀⠀⠀⠀⠀⠀⠀⠀⠀⠀⢸⡇⠀⢀⣠⡤⠶⠞⠛⠛⠛⠛⢛⣒⣶⠶⠤⣉⡀⠀⠈⠙⠷⣦⣀⠀⠀⠀⠀⠀⠀⠀⠀⠀⠀⠀⠀⠀⠀⠀
⠀⠀⠀⠀⠀⠀⠀⠀⠀⠀⠀⠀⠀⠀⠀⠀⠀⠀⠀⠀⠀⠀⠀⠀⠀⠘⢷⣄⡉⠁⠀⠀⠀⠀⠀⣠⠾⠋⠁⢀⣠⣤⣬⣭⣟⣶⣄⠀⠈⠙⠷⣤⡀⠀⠀⠀⠀⠀⠀⠀⠀⠀⠀⠀⠀
⠀⠀⠀⠀⠀⠀⠀⠀⠀⠀⠀⠀⠀⠀⠀⠀⠀⠀⠀⠀⠀⠀⠀⠀⠀⠀⠀⠈⠛⠷⣤⠀⠀⠀⠀⢋⣠⡶⠛⠋⠁⠀⠀⠀⠈⠙⠻⢷⣄⠀⠀⠈⠻⣦⣄⠀⠀⠀⠀⠀⠀⠀⠀⠀⠀
⠀⠀⠀⠀⠀⠀⠀⠀⠀⠀⠀⠀⠀⠀⠀⠀⠀⠀⠀⠀⠀⠀⠀⠀⠀⠀⠀⠀⠀⠀⠈⣷⠀⠀⣴⠿⠉⠀⠀⠀⠀⠀⠀⠀⠀⠀⠀⠀⢻⣧⠀⠀⠀⠀⠙⢷⣄⠀⠀⠀⠀⠀⠀⠀⠀
⠀⠀⠀⠀⠀⠀⠀⠀⠀⠀⠀⠀⠀⠀⠀⠀⠀⠀⠀⠀⠀⠀⠀⠀⠀⠀⠀⠀⠀⠀⠀⠙⠷⠾⠋⠀⠀⠀⠀⠀⠀⠀⠀⠀⠀⠀⠀⠀⠀⢻⡆⠀⠀⠀⠀⠀⠙⢷⡄⠀⠀⠀⠀⠀⠀
⠀⠀⠀⠀⠀⠀⠀⠀⠀⠀⠀⠀⠀⠀⠀⠀⠀⠀⠀⠀⠀⠀⠀⠀⠀⠀⠀⠀⠀⠀⠀⠀⠀⠀⠀⠀⠀⠀⠀⠀⠀⠀⠀⠀⠀⠀⠀⠀⠀⠘⣧⠀⠀⠀⠀⠀⠀⠀⠻⣦⠀⠀⠀⠀⠀
⠀⠀⠀⠀⠀⠀⠀⠀⠀⠀⠀⠀⠀⠀⠀⠀⠀⠀⠀⠀⠀⠀⠀⠀⠀⠀⠀⠀⠀⠀⠀⠀⠀⠀⠀⠀⠀⠀⠀⠀⠀⠀⠀⠀⠀⠀⠀⠀⠀⢰⡏⠀⠀⠀⠀⠀⠀⠀⠀⠙⢷⡀⠀⠀⠀
⠀⠀⠀⠀⠀⠀⠀⠀⠀⠀⠀⠀⠀⠀⠀⠀⠀⢠⣦⡀⠀⠀⠀⠀⠀⠀⠀⠀⠀⠀⠀⠀⠀⠀⠀⠀⠀⠀⠀⠀⠀⠀⠀⠀⠀⠀⠀⠀⠀⢸⡇⠀⠀⠀⠀⠀⠀⠀⠀⠀⠘⢿⡄⠀⠀
⠀⠀⠀⠀⠀⠀⠀⠀⠀⠀⠀⠀⠀⠀⠀⠀⢠⡟⠙⢷⡀⠀⠀⠀⠀⠀⠀⠀⠀⠀⠀⠀⠀⠀⠀⠀⠀⠀⠀⠀⠀⠀⠀⠀⠀⠀⠀⠀⠀⣿⠀⠀⠀⠀⠀⠀⠀⠀⠀⠀⠀⠘⣷⡀⠀
⠀⠀⠀⠀⠀⠀⠀⠀⠀⠀⠀⠀⠀⠀⣀⣤⡿⠁⠀⠘⣷⡒⠶⠶⣤⣀⠀⠀⠀⠀⠀⠀⠀⠀⠀⠀⠀⠀⠀⠀⠀⠀⠀⠀⠀⠀⠀⠀⣸⡏⠀⠀⠀⠀⠀⠀⠀⠀⠀⠀⠀⠀⢸⣇⠀
⠀⠀⠀⠀⠀⠀⠀⠀⠀⠀⠀⢀⣴⠞⠋⠘⠁⠀⠀⠀⠈⠁⠀⠀⠀⠉⠻⣦⡀⠀⠀⠀⠀⠀⠀⠀⠀⠀⠀⠀⠀⠀⠀⠀⠀⠀⠀⣰⡟⠀⠀⠀⠀⠀⠀⠀⠀⠀⠀⠀⠀⠀⠀⣿⡀
⠀⠀⠀⠀⠀⠀⠀⠀⠀⠀⢠⡿⠁⠀⠀⠀⠀⠀⠀⠀⠀⠀⠀⠀⠀⠀⠀⠈⠻⣦⡀⠀⠀⠀⠀⠀⠀⠀⠀⠀⠀⠀⠀⠀⠀⠀⣴⡟⠀⠀⠀⠀⠀⠀⠀⠀⠀⠀⠀⠀⠀⠀⠀⢹⡇
⠀⠀⠀⠀⠀⠀⠀⠀⠀⢠⡿⢀⡀⠀⠀⠀⠀⠀⠀⠀⠀⠀⠀⢀⣀⠀⠀⠀⠀⠈⢿⣆⠀⠀⠀⠀⠀⠀⠀⠀⠀⠀⠀⠀⣠⡾⠋⠀⠀⠀⠀⠀⠀⠀⠀⠀⠀⠀⠀⠀⠀⠀⠀⢸⡇
⠀⠀⠀⠀⠀⠀⠀⠀⠀⣼⢁⣟⢹⡄⠀⠀⠀⠀⠀⠀⠀⠀⢰⣿⠉⢹⡄⠀⠀⠀⠀⠙⢷⣄⡀⠀⠀⠀⠀⠀⢀⣀⣴⠞⠋⠀⠀⠀⠀⠀⠀⠀⠀⠀⠀⠀⠀⠀⠀⠀⠀⠀⠀⢸⡇
⠀⠀⠀⠀⠀⠀⠀⠀⠀⣿⢸⣿⣿⡇⠀⠀⠀⠀⠀⠀⠀⠀⣾⣿⣷⣿⡇⠀⠀⠀⠀⠀⠀⠉⠙⠛⠲⠶⠖⠛⠋⠉⠀⠀⠀⠀⠀⠀⠀⠀⠀⠀⠀⠀⠀⠀⠀⠀⠀⠀⠀⠀⠀⢸⡇
⠀⠀⠀⠀⠀⠀⠀⢠⡾⠋⠘⠻⠿⠃⠀⣤⣤⣤⡄⠀⠀⠀⠼⠿⠿⠿⠇⠀⠀⠀⠀⠀⠀⠀⠀⠀⠀⠀⠀⠀⠀⠀⠀⠀⠀⠀⠀⠀⠀⠀⠀⠀⠀⠀⠀⠀⠀⠀⠀⠀⠀⠀⠀⣸⡇
⠀⠀⠀⠀⠀⠀⠀⣿⠀⠀⠀⠀⠀⠀⠀⠀⠈⠉⠀⠀⠀⠀⠀⠀⠀⠀⢀⠀⠀⠀⠀⠀⠀⠀⠀⠀⠀⠀⠀⠀⠀⠀⠀⠀⠀⠀⠀⠀⠀⠀⠀⠀⠀⠀⠀⠀⠀⠀⠀⠀⠀⠀⢀⣿⠀
⠀⠀⠀⠀⠀⠀⠀⠻⢦⣤⣤⣤⠤⡶⠶⠿⢿⠻⠿⣷⡶⣦⣤⣀⣀⣠⡞⠀⠀⠀⠀⠀⠀⠀⠀⠀⠀⠀⠀⠀⠀⠀⠀⠀⠀⠀⠀⠀⠀⠀⠀⠀⠀⠀⠀⠀⠀⠀⠀⠀⠀⠀⢸⡏⠀
⠀⠀⠀⠀⠀⠀⠀⠀⠀⠀⠘⢷⣸⢷⣅⣚⣀⠀⠀⢠⣄⣹⣆⣹⢏⣹⠟⠀⠀⠀⠀⠀⠀⠀⠀⠀⡀⢀⠀⠀⠀⠀⠀⠀⠀⠀⠀⠀⠀⠀⠀⠀⠀⠀⠀⠀⠀⠀⠀⠀⢀⣴⣿⠃⠀
⠀⠀⠀⠀⠀⠀⠀⠀⠀⠀⠀⠀⠉⠳⢮⣍⣉⣉⡙⢉⣉⣉⣹⡷⠟⡹⠀⠀⠀⠀⠀⠀⠀⠀⠀⣄⠹⣾⣷⣄⠀⠀⠀⠀⠀⠀⠀⠀⠀⠀⠀⠀⠀⠀⠀⠀⠀⠀⣀⣠⣮⣼⠏⠀⠀
⠀⠀⠀⠀⠀⠀⠀⠀⠀⠀⠀⠀⠀⠀⠀⠈⠉⣿⡉⠉⠉⠉⠁⢀⡜⠁⠀⠀⠀⠀⠀⠀⠰⣧⠀⢻⡄⠀⠉⠙⠛⠶⠶⢶⣤⣤⣤⣤⣤⣤⣤⣤⣤⣴⠶⠶⢞⠛⠋⢡⣿⠏⠀⠀⠀
⠀⠀⠀⠀⠀⠀⠀⠀⠀⠀⠀⠀⠀⠀⠀⢠⡾⣿⣧⡄⡀⠤⠔⠃⠀⠀⠀⠀⠀⠀⠀⠀⠀⠹⣦⠀⢻⣆⠀⠀⠀⠀⠀⠀⠀⠀⠀⠀⠀⠀⠀⣀⡄⢀⣤⡴⠋⠀⠀⣿⠏⠀⠀⠀⠀
⠀⠀⠀⠀⠀⠀⠀⠀⠀⠀⠀⠀⠀⣠⡾⢋⣿⠋⠙⣷⡀⠀⠀⠀⠀⠀⠀⠀⠀⠀⠀⠀⠀⠀⠹⣧⠀⠹⣧⡀⠀⠀⠀⠘⠛⠒⠶⠶⠶⠶⠟⠛⠛⠉⠁⠀⠀⠀⠀⠹⣧⡀⠀⠀⠀
⠀⠀⠀⠀⠀⠀⠀⠀⠀⠀⣀⣴⠾⢋⣰⠟⠁⢀⡴⡏⢿⣦⡀⠀⠀⠀⠀⠀⠀⠀⠀⠀⠀⠀⠀⠙⣷⡄⠈⢿⣶⠴⣦⡀⠀⠀⠀⠀⠀⠀⠀⠀⠀⠀⠀⠀⠀⠀⠀⠀⣿⠇⠀⠀⠀
⠀⠀⠀⠀⠀⠀⣀⣠⡶⠞⠋⠁⠀⠉⠁⣠⡶⡯⠏⠀⣸⠟⢿⣗⡢⠄⣀⡀⠀⠀⠀⠀⠀⠀⠀⠀⠈⠻⣦⠀⠙⢷⣌⠙⠷⢦⣄⣀⡀⠀⠀⠀⠀⠀⠀⠀⢀⣠⣴⠾⠋⠀⠀⠀⠀
⢀⣠⣤⣴⡶⠟⠋⠉⠀⠀⠀⠀⢀⣴⠞⣫⠞⠁⠀⣰⠏⠀⢰⡟⠿⣦⣄⠈⠉⠀⠀⠀⠀⠀⠀⠀⠀⠀⠙⢷⣄⠀⠉⠳⣦⣄⠈⠉⠉⠛⠛⠃⠀⠀⠀⣴⠋⠁⠀⠀⠀⠀⠀⠀⠀
⠻⣯⣄⣀⠀⠀⠀⠀⠀⣤⠴⠞⢋⠤⠊⠀⠀⠀⣀⡁⠀⣠⡟⠁⠀⠈⠙⠻⢶⣤⣀⠀⠀⠀⠀⠀⠀⠀⠀⠀⠙⢷⣄⠀⠀⠉⠁⠀⠀⠀⠀⠀⠀⠀⣀⣿⠀⠀⠀⠀⠀⠀⠀⠀⠀
⠀⠀⠈⠉⠻⣦⠀⠀⠀⣀⠤⢊⣵⢶⣄⠀⢀⣾⠋⠙⠛⠋⠀⠀⠀⠀⠀⠀⠀⠈⠉⠛⠛⠷⠶⢶⣶⣶⣶⣶⠶⠾⠿⢿⣦⣀⠀⠀⢀⣴⠶⠛⠛⠛⠛⠁⠀⠀⠀⠀⠀⠀⠀⠀⠀
⠀⠀⠀⠀⠀⠙⣷⣤⣉⣀⣴⡟⠁⠀⠉⢻⡿⠃⠀⠀⠀⠀⠀⠀⠀⠀⠀⠀⠀⠀⠀⠀⠀⠀⠀⠀⠀⠀⠀⠀⠀⠀⠀⠀⠈⠛⢿⣶⡟⠁⠀⠀⠀⠀⠀⠀⠀⠀⠀⠀⠀⠀⠀⠀⠀