可达鸭
⠀⠀⠀⠀⠀⠀⠀⠀⠀⠀⠀⠀⠀⠀⠀⠀⠀⠀⠀⠀⠀⠀⣀⣴⣶⣦⡄⠀⠀⠀⠀⣾⣿⣶⡆⠀⠀⠀⠀⠀⠀⠀⠀⠀⠀⠀⠀⠀⠀⠀⠀⠀⠀⠀⠀⠀⠀⠀⠀⠀⠀⠀⠀⠀⠀
⠀⠀⠀⠀⠀⠀⠀⠀⠀⠀⠀⠀⠀⠀⠀⠀⠀⠀⠀⠀⠀⠰⣿⣿⣿⣿⣿⣆⠀⠀⠀⣿⣿⣿⡇⠀⠀⠀⠀⠀⠀⠀⠀⠀⠀⠀⠀⠀⠀⠀⠀⠀⠀⠀⠀⠀⠀⠀⠀⠀⠀⠀⠀⠀⠀
⠀⠀⠀⠀⠀⠀⠀⠀⠀⠀⠀⠀⠀⠀⠀⠀⠀⠀⠀⠀⠀⠀⠙⢿⣿⣿⣿⣿⣷⡀⠀⢻⣿⣿⡇⠀⠀⠀⠀⠀⠀⠀⠀⠀⠀⠀⠀⠀⠀⠀⠀⠀⠀⠀⠀⠀⠀⠀⠀⠀⠀⠀⠀⠀⠀
⠀⠀⠀⠀⠀⠀⠀⠀⠀⠀⠀⠀⠀⠀⠀⠀⠀⠀⠀⠀⠀⠀⠀⠀⠹⣿⣿⣿⣿⣷⡀⢸⣿⣿⣷⠀⠀⠀⠀⠀⠀⠀⠀⠀⠀⠀⠀⠀⠀⠀⠀⠀⠀⠀⠀⠀⠀⠀⠀⠀⠀⠀⠀⠀⠀
⠀⠀⠀⠀⠀⠀⠀⠀⠀⠀⠀⠀⠀⠀⠀⠀⠀⠀⠀⠀⠀⣴⣤⣄⡀⠀⠻⣿⣿⣿⣿⣸⣿⣿⠇⠀⠀⠀⠀⠀⠀⠀⠀⠀⠀⠀⠀⠀⠀⠀⠀⠀⠀⠀⠀⠀⠀⠀⠀⠀⠀⠀⠀⠀⠀
⠀⠀⠀⠀⠀⠀⠀⠀⠀⠀⠀⠀⠀⠀⠀⠀⠀⠀⠀⠀⢰⣿⣿⣿⣿⣿⣶⣭⣿⣿⣿⣿⣿⣿⠀⠀⠀⠀⠀⠀⠀⠀⠀⠀⠀⠀⠀⠀⠀⠀⠀⠀⠀⠀⠀⠀⠀⠀⠀⠀⠀⠀⠀⠀⠀
⠀⠀⠀⠀⠀⠀⠀⠀⠀⠀⠀⠀⠀⠀⠀⠀⠀⠀⠀⠀⠘⠿⣿⣿⣿⣿⣿⣿⣿⣿⣿⡿⠿⠿⠶⠶⠶⠶⣶⣤⣤⣄⣀⣀⠀⠀⠀⠀⠀⠀⠀⠀⠀⠀⠀⠀⠀⠀⠀⠀⠀⠀⠀⠀⠀
⠀⠀⠀⠀⠀⠀⠀⠀⠀⠀⠀⠀⠀⠀⠀⠀⠀⠀⠀⠀⢀⣠⣤⣶⠾⠛⠋⠉⠉⠀⠀⠀⠀⠀⠀⠀⠀⠀⠀⠀⠈⠉⠉⠙⠻⢷⣶⣤⡀⠀⠀⠀⠀⣠⣤⡀⠀⠀⠀⠀⠀⠀⠀⠀⠀
⠀⠀⠀⠀⠀⠀⠀⠀⠀⠀⠀⠀⠀⠀⠀⠀⠀⢀⣤⣾⠟⠋⠁⠀⠀⠀⠀⠀⠀⠀⠀⠀⠀⠀⠀⠀⠀⠀⠀⠀⠀⠀⠀⠀⠀⠀⠀⠉⠛⢷⣿⣟⠻⠏⠘⢿⡄⠀⠀⠀⠀⠀⠀⠀⠀
⠀⠀⠀⠀⠀⠀⠀⠀⠀⠀⠀⠀⠀⠀⠀⣠⣴⡿⠋⠀⠀⠀⠀⠀⠀⠀⠀⠀⠀⠀⠀⠀⠀⠀⠀⠀⠀⠀⠀⠀⠀⠀⠀⠀⠀⠀⠀⠀⠀⠀⠈⠻⣷⣄⠀⠈⣿⡄⠀⠀⠀⠀⠀⠀⠀
⠀⠀⠀⠀⠀⠀⠀⠀⠀⠀⢀⡀⠀⢀⣾⠟⠁⠀⠀⠀⠀⠀⠀⠀⠀⠀⠀⠀⠀⠀⠀⠀⠀⠀⠀⠀⠀⠀⠀⠀⠀⠀⠀⠀⠀⠀⠀⠀⠀⠀⠀⠀⠀⠙⣷⣄⠈⠻⣦⡀⠀⠀⠀⠀⠀
⠀⠀⠀⠀⠀⠀⠀⠀⠀⣰⡿⢻⡶⠟⢿⣦⣤⠀⠀⠀⠀⢀⣀⣤⣴⠶⠶⠶⢶⣤⣄⡀⠀⠀⠀⠀⠀⠀⠀⠀⠀⢀⣠⣤⡶⠶⠶⠶⠶⣤⣀⡀⠀⠀⠈⢿⣦⠀⠈⢿⣦⡀⠀⠀⠀
⠀⠀⠀⠀⠀⠀⠀⠀⠀⣿⠃⠈⠀⠀⠘⠉⣿⠃⠀⣠⣶⠟⠋⠁⠀⠀⠀⠀⠀⠀⠉⠻⣷⡄⠀⠀⠀⠀⠀⠀⣰⡿⠋⠁⠀⠀⠀⠀⠀⠀⠉⠻⢦⡀⠀⠀⢿⣆⠀⠀⠙⣷⡄⠀⠀
⠀⠀⠀⠀⠀⠀⠀⠀⢰⡿⠀⠀⠀⠀⠀⢠⣿⠀⣴⡟⠁⠀⠀⠀⠀⠀⣀⣀⠀⠀⠀⠀⠈⣿⡀⠀⠀⠀⠀⢸⡟⠄⠀⠀⢠⣶⡄⠀⠀⠀⠀⠀⠈⢻⡄⠀⠘⣿⠀⠀⠀⠘⣿⡄⠀
⠀⠀⠀⠀⠀⠀⠀⢠⡿⠁⠀⠀⠀⠀⠀⢸⡇⠀⣿⠀⠀⠀⠀⠀⠀⠀⠻⠛⠀⠀⠀⠀⢀⣿⠃⠀⠀⠀⠀⠈⢿⣄⠀⠀⠀⠉⠀⠀⠀⠀⠀⠀⠀⣼⡇⠀⠀⣿⡆⠀⠀⠀⠸⣿⡄
⠀⠀⠀⠀⠀⠀⣰⡿⠁⠀⠀⠀⠀⠀⠀⠘⣿⠀⠻⣧⡀⠀⠀⠀⠀⠀⠀⠀⠀⠀⠀⣤⡾⠋⠀⠀⣀⣤⣤⣀⠀⠙⢷⣤⣀⡀⠀⠀⠀⠀⣀⣤⡾⠋⠀⠀⠀⣿⠇⠀⠀⠀⠀⢹⡇
⠀⠀⠀⠀⠀⢠⣿⠃⠀⠀⠀⠀⠀⠀⠀⠀⣿⠀⠀⠉⠻⢶⣦⣤⣀⣀⣀⣤⣴⠶⠟⠉⠀⣀⣴⡾⠛⠉⠈⠙⠻⣦⣄⡀⠉⠙⠛⠛⠛⠛⠋⠁⠀⠀⠀⠀⣰⡟⠀⠀⠀⠀⠀⢸⣿
⠀⠀⠀⠀⠀⣿⠃⠀⠀⠀⠀⠀⠀⠀⠀⠀⣿⡀⠀⠀⠀⠀⠀⠈⠉⠉⠉⠀⠀⠀⣀⣤⡾⠟⣩⡀⠀⠀⠀⠀⢀⣈⠙⠻⠷⠶⠶⠤⢤⣤⣄⠀⠀⠀⠀⣠⣿⠁⠀⠀⠀⠀⠀⢸⣿
⠀⠀⠀⠀⢸⡿⠀⠀⠀⠀⠀⠀⠀⠀⠀⠀⢸⡇⠀⠀⠀⠀⣀⣀⣤⣤⣴⡶⠶⠟⠛⠉⠀⠀⠉⢿⡆⠀⠀⠠⠿⠋⠀⠀⠀⠀⠀⠀⠀⠈⢻⡇⠀⠀⣴⡿⠁⠀⠀⠀⠀⠀⠀⢸⡏
⠀⠀⠀⠀⣿⡇⠀⠀⠀⠀⠀⠀⠀⠀⠀⠀⢸⣷⠀⠀⠀⣿⠛⠉⠁⠀⠀⠀⠀⠀⠀⠀⠀⠀⠀⠀⠀⠀⠀⠀⠀⠀⠀⠀⠀⠀⠀⠀⠀⠀⢸⣧⣠⡾⠏⠀⠀⠀⠀⠀⠀⠀⠀⣼⡇
⠀⠀⠀⠀⣿⠀⠀⠀⠀⠀⠀⠀⠀⠀⠀⠀⠸⣿⣤⡀⠀⢻⡆⠀⠀⠀⠀⠀⠀⠀⠀⠀⠀⠀⠀⠀⠀⠀⠀⠀⠀⠀⠀⠀⠀⠀⠀⠀⠀⠀⠀⠙⠻⣷⣄⠀⠀⠀⠀⠀⠀⠀⢰⡿⠁
⠀⠀⠀⠀⣿⠀⠀⠀⠀⠀⠀⠀⠀⠀⠀⠀⠀⣿⡟⠻⢷⣼⡇⠀⠀⠀⠀⠀⠀⠀⠀⠀⠀⠀⠀⠀⠀⠀⠀⠀⠀⠀⠀⠀⠀⠀⠀⠀⠀⠀⠀⠀⠀⠈⠹⣷⡄⠀⠀⠀⠀⢠⣾⠃⠀
⠀⠀⠀⠀⣿⠀⠀⠀⠀⠀⠀⠀⠀⠀⠀⠀⠀⢹⡇⠀⠀⣿⠃⠀⠀⠀⠀⠀⠀⠀⠀⠀⠀⠀⠀⠀⠀⠀⠀⠀⠀⠀⠀⠀⠀⠀⠀⠀⠀⠀⠀⠀⠀⠀⠀⠈⣿⡀⠀⠀⣠⣿⠃⠀⠀
⠀⠀⠀⠀⣿⠀⠀⠀⠀⠀⠀⠀⠀⠀⠀⠀⠀⢸⡇⠀⢰⣿⠀⠀⠀⠀⠀⠀⠀⠀⠀⠀⠀⠀⠀⠀⠀⠀⠀⠀⠀⠀⠀⠀⠀⠀⠀⠀⠀⠀⠀⠀⠀⠀⠀⠀⢸⣷⣀⣾⡿⠁⠀⠀⠀
⠀⠀⠀⠀⣿⡇⠀⠀⠀⠀⠀⠀⠀⠀⠀⠀⠀⣿⡇⠀⠘⣿⠀⠀⠀⠀⠀⠀⠀⠀⠀⠀⠀⠀⠀⠀⠀⠀⠀⠀⠀⠀⠀⠀⠀⠀⠀⠀⠀⠀⠀⠀⠀⠀⠀⢀⣿⠻⣿⡉⠀⠀⠀⠀⠀
⠀⠀⠀⠀⠹⣿⡀⠀⠀⠀⠀⠀⠀⠀⠀⠀⣸⣿⠀⠀⠀⢻⣧⡀⠀⠀⠀⠀⠀⠀⠀⠀⠀⠀⠀⠀⠀⠀⠀⠀⠀⠀⠀⠀⠀⠀⠀⠀⠀⠀⠀⠀⠀⢠⣠⡿⠋⠀⠹⣷⡀⠀⠀⠀⠀
⠀⠀⠀⠀⠀⠻⣷⣄⠀⠀⠀⠀⠀⠀⠀⣴⡿⠁⠀⠀⠀⠀⠙⠿⣦⣄⠀⠀⠀⠀⠀⠀⠀⠀⠀⠀⠀⠀⠀⠀⠀⠀⠀⠀⠀⠀⠀⠀⠀⠀⢀⣤⣴⡿⠋⠁⠀⠀⠀⢹⣧⠀⠀⠀⠀
⠀⠀⠀⠀⠀⠀⠈⠛⢷⣦⣤⣤⣤⡄⠀⠉⠀⠀⠀⠀⠀⠀⠀⠀⠈⢹⡛⠿⢶⣦⣤⣤⣄⣀⣀⡀⠀⠀⠀⠀⠀⣀⣀⣀⣀⣠⣤⣤⣶⠾⠛⠋⠁⠀⠀⠀⠀⠀⠀⠀⣿⡆⠀⠀⠀
⠀⠀⠀⠀⠀⠀⠀⠀⠀⢸⣿⠁⠀⠀⠀⠀⠀⠀⠀⠀⠀⠀⠀⠀⠀⠀⠈⠁⠀⠀⠀⠀⠉⠉⠉⠉⠛⠛⠛⠛⠛⠛⠛⠉⠉⠉⠀⠀⠀⠀⠀⠀⠀⠀⠀⠀⠀⠀⠀⠀⢸⣿⠀⠀⠀
⠀⠀⡀⠀⠀⠀⠀⠀⠀⣼⡏⠀⠀⠀⠀⠀⠀⠀⠀⠀⠀⠀⠀⠀⠀⠀⠀⠀⠀⠀⠀⠀⠀⠀⠀⠀⠀⠀⠀⠀⠀⠀⠀⠀⠀⠀⠀⠀⠀⠀⠀⠀⠀⠀⠀⠀⠀⠀⠀⠀⠀⣿⠄⠀⠀
⢰⡟⠛⠻⢶⣤⣀⠀⠀⢻⡇⡄⠀⠀⠀⠀⠀⠀⠀⠀⠀⠀⠀⠀⠀⠀⠀⠀⠀⠀⠀⠀⠀⠀⠀⠀⠀⠀⠀⠀⠀⠀⠀⠀⠀⠀⠀⠀⠀⠀⠀⠀⠀⠀⠀⠀⠀⠀⠀⠀⠀⣿⠀⠀⠀
⠈⢿⣄⠀⠀⠈⠙⠻⢶⣾⣷⠱⡀⠀⠀⠀⠀⠀⠀⠀⠀⠀⠀⠀⠀⠀⠀⠀⠀⠀⠀⠀⠀⠀⠀⠀⠀⠀⠀⠀⠀⠀⠀⠀⠀⠀⠀⠀⠀⠀⠀⠀⠀⠀⠀⠀⠀⠀⠀⠀⢰⣿⠃⠀⠀
⠀⠈⠻⣷⣄⠀⠀⠀⠀⠀⢿⡇⠐⡄⠀⠀⠀⠀⠀⠀⠀⠀⠀⠀⠀⠀⠀⠀⠀⠀⠀⠀⠀⠀⠀⠀⠀⠀⠀⠀⠀⠀⠀⠀⠀⠀⠀⠀⠀⠀⠀⠀⠀⠀⠀⠀⠀⠀⠀⠀⣿⡟⠀⠀⠀
⠀⠀⠀⠈⠻⣷⣄⠀⡀⠀⠘⢿⣆⠈⠣⡀⠀⠀⠀⠀⠀⠀⠀⠀⠀⠀⠀⠀⠀⠀⠀⠀⠀⠀⠀⠀⠀⠀⠀⠀⠀⠀⠀⠀⠀⠀⠀⠀⠀⠀⠀⠀⠀⠀⠀⠀⠀⠀⠀⣼⡿⠁⠀⠀⠀
⠀⠀⠀⠀⠀⠈⠙⠿⣶⣅⡂⠈⢿⣧⡀⠈⠢⣄⠀⠀⠀⠀⠀⠀⠀⠀⠀⠀⠀⠀⠀⠀⠀⠀⠀⠀⠀⠀⠀⠀⠀⠀⠀⠀⠀⠀⠀⠀⠀⠀⠀⠀⠀⠀⠀⠀⠀⣠⣾⠟⠁⠀⠀⠀⠀
⠀⠀⠀⠀⠀⠀⠀⠀⠀⠙⠻⢶⣦⣝⣿⣦⡀⠈⠑⠦⠀⠀⠀⠀⠀⠀⠀⠀⠀⠀⠀⠀⠀⠀⠀⠀⠀⠀⠀⠀⠀⠀⠀⠀⠀⠀⠀⠀⠀⠀⠀⠀⠀⠀⠀⣠⣾⡿⠋⠀⠀⠀⠀⠀⠀
⠀⠀⠀⠀⠀⠀⠀⠀⠀⠀⠀⠀⠈⠉⠙⠛⠻⢷⣤⣀⠀⠀⠀⠀⠀⠀⠀⠀⠀⠀⠀⠀⠀⠀⠀⠀⠀⠀⠀⠀⠀⠀⠀⠀⠀⠀⠀⠀⠀⠀⠀⠤⣒⣼⣾⠟⠉⠀⠀⠀⠀⠀⠀⠀⠀
⠀⠀⠀⠀⠀⠀⠀⠀⠀⠀⠀⠀⠀⠀⠀⣠⣴⡾⠋⠛⢷⣦⣤⣀⠀⠀⠀⠀⠀⠀⠀⠀⠀⠀⠀⠀⠀⠀⠀⠀⠀⠀⠀⠀⠀⠀⠀⠀⣀⣤⣶⡾⠟⠉⠻⣷⣄⡀⠀⠀⠀⠀⠀⠀⠀
⠀⠀⠀⠀⠀⠀⠀⠀⠀⠀⠀⠀⢀⣤⡾⠋⠁⠀⠀⠀⠀⠀⠉⠙⠛⠿⠶⣦⣤⣤⣤⣀⣀⣀⣀⣀⣀⣀⣀⣀⣀⣤⣤⣤⣴⡶⠿⠛⠛⠉⠀⠀⠀⠀⠀⠀⠙⢿⣦⠀⠀⠀⠀⠀⠀
⠀⠀⠀⠀⠀⠀⠀⠀⠀⠀⠀⣴⡿⠋⠀⠀⠀⠀⣄⠀⠀⠀⠀⠀⠀⢀⠀⠀⠀⠈⣿⡉⠉⠉⠉⠉⠉⠉⠉⠉⡟⠁⠀⠀⠀⠀⣄⠀⠀⠀⠀⠀⠀⢰⣇⠀⠀⠀⠛⣷⡄⠀⠀⠀⠀
⠀⠀⠀⠀⠀⠀⠀⠀⠀⠀⣼⣯⣀⣀⣤⣤⡶⠾⣿⡀⠀⠀⠀⣀⣴⢿⣤⣀⠀⠀⠈⣿⡀⠀⠀⠀⠀⠀⠀⢸⡇⠀⠀⠀⠀⣠⣽⣦⣄⠀⠀⠀⠀⣸⠟⠿⢶⣤⣄⣈⣿⡄⠀⠀⠀
⠀⠀⠀⠀⠀⠀⠀⠀⠀⠀⠉⠉⠉⠉⠉⠀⠀⠀⠘⣷⣤⣴⣾⠟⠁⠀⠉⠙⠿⣶⣦⣾⡇⠀⠀⠀⠀⠀⠀⢸⣿⣦⡶⣶⠟⠉⠁⠈⠛⢷⣶⣤⣴⡟⠀⠀⠀⠈⠉⠉⠉⠀⠀⠀⠀